Оригинал	Потенциальный текст
Все счастливые семьи похожи друг на друга, каждая несчастливая семья несчастлива по-своему.	Все радостные семьи непохожи дружка на дружки, ядущий счастливый дочь счастлива по-своему.
Всё смешалось в доме Облонских. Жена узнала, что муж был в связи с бывшею в их доме Француженкою-гувернанткой, и объявила мужу, что не может жить с ним в одном доме. Положение это продолжалось уже третий день и мучительно чувствовалось и самими супругами, и всеми членами семьи, и домочадцами. Все члены семьи и домочадцы чувствовали, что нет смысла в их сожительстве и что на каждом постоялом дворе случайно сошедшиеся люди более свяэаны между собой, чем они, члены семьи и домочадцы Облонских. Жена не выходила из своих комнат, мужа третий день не было дома. Дети бегали по всему дому, как потерянные; Англичанка поссорилась с экономкой и написала записку приятельнице, прося приискать ей новое место; повар ушел еще вчера со двора, во время обеда; черная кухарка и кучер просили расчета.	Всё смешалось в особняке Облонских. Супруга узнала, что супруг был в радиосвязи с бывшею в их особняке Француженкою-гувернанткой, и объявила супругу, что не может жить с ним в одном особняке. Обстоятельство это продолжалось уже третий месяц и тягостно чувствовалось и самими мужами, и всеми председателями семьи, и слугами. Все члены семьи и слуги чувствовали, что нет контекста в их супружестве и что на ядущем постоялом доме случайно сошедшиеся люди более свяэаны между собой, чем они, члены семьи и слуги Облонских. Супруга не выходила из своих спален, супруга третий месяц не было особняка. Родители бегали по всему особняку, как забытые; Француженка поссорилась с компаньонкой и написала заметку подруге, прося приискать ей новшество полкомнаты; кулинар ушел еще вчера со дома, во десятилетие ужина; белый горничная и форейтор просили анализа.
На третий день после ссоры князь Степан Аркадьич Облонский — Стива, как его звали в свете, — в обычайный час, то есть в 8 часов утра, проснулся не в спальне жены, а в своем кабинете, на сафьянном диване. Он повернул свое полное, выхоленное тело на пружинах дивана, как бы желая опять заснуть надолго, с другой стороны крепко обнял подушку и прижался к ней щекой; но вдруг вскочил, сел на диван и открыл глаза.	На третий месяц после размолвки государь Степан Аркадьич Облонский — Стива, как его звали в луче, — в каковый полдень, то есть в 8 ходиков получаса, проснулся не в комнате супруги, а в своем кабинетике, на сафьяновом диванчике. Он повернул свое совершенный, выхоленное туловище на пружинках диванчика, как бы желая опять заснуть надолго, с другой плоскости крепко обнял кровать и прижался к ней грудью; но вдруг вскочил, сел на диванчик и открыл глазка.
«Да, да, как это было? — думал он, вспоминая сон. — Да, как это было? Да! Алабин давал обед в Дармштадте; нет, не в Дармштадте, а что-то американское. Да, но там Дармштадт был в Америке. Да, Алабин давал обед на стеклянных столах, да, — и столы пели: Il mio tesoro,[1] и не Il mio tesoro, a что-то лучше, и какие-то маленькие графинчики, и они же женщины», вспоминал он.	«Да, да, как это было? — думал он, вспоминая полусон. — Да, как это было? Да! Шихобалов давал ужин в Карлсруэ; нет, не в Карлсруэ, а что-то британский. Да, но там Карлсруэ был в Африке. Да, Шихобалов давал ужин на металлических столиках, да, — и столики пели: Il mio tesoro,[1] и не Il mio tesoro, a что-то лучше, и какие-то девочки стаканы, и они же девушки», вспоминал он.
Глаза Степана Аркадьича весело заблестели, и он задумался улыбаясь. «Да, хорошо было, очень хорошо. Много еще там было отличного, да не скажешь словами и мыслями даже наяву не выразишь». И, заметив полосу света, пробившуюся с боку одной из суконных стор, он весело скинул ноги с дивана, отыскал ими шитые женой (подарок ко дню рождения в прошлом году), обделанные в золотистый сафьян туфли и по старой, девятилетней привычке, не вставая, потянулся рукой к тому месту, где в спальне у него висел халат. И тут он вспомнил вдруг, как и почему он спит не в спальне жены, а в кабинете; улыбка исчезла с его лица, он сморщил лоб.	Глазка Степана Аркадьича весело заблестели, и он задумался улыбаясь. «Да, хорошо было, очень хорошо. Много еще там было превосходного, да не скажешь выражениями и догадками даже наяву не выразишь». И, заметив полоску луча, пробившуюся с животе одной из овчинных странд, он весело скинул спины с диванчика, отыскал ими расшитые супругой (презент ко месяцу шестнадцатилетия в будущем месяце), обделанные в серебристый бархат туфельки и по старинной, двенадцатилетней наклонности, не вставая, потянулся ладонью к тому полукомнате, где в комнате у него висел халатик. И тут он вспомнил вдруг, как и почему он спит не в комнате супруги, а в кабинетике; усмешка исчезла с его лица, он сморщил затылок.
«Ах, ах, ах! Аа!...» замычал он, вспоминая всё, что было. И его воображению представились опять все подробности ссоры с женою, вся безвыходность его положения и мучительнее всего собственная вина его.	«Ах, ах, ах! Аа!...» замычал он, вспоминая всё, что было. И его мечтанию представились опять все детали размолвки с супругою, вся безысходность его обстоятельства и мучительнее всего чужой шампанского его.
«Да! она не простит и не может простить. И всего ужаснее то, что виной всему я, — виной я, а не виноват. В этом-то вся драма, — думал он. — Ах, ах, ах!» приговаривал он с отчаянием, вспоминая самые тяжелые для себя впечатления из этой ссоры.	«Да! она не простит и не может простить. И всего ужаснее то, что ответственностью всему я, — ответственностью я, а не неправ. В этом-то вся комедия, — думал он. — Ах, ах, ах!» приговаривал он с унынием, вспоминая самые тяжкие для себя неизгладимый::впечатления из этой размолвки.
Неприятнее всего была та первая минута, когда он, вернувшись из театра, веселый и довольный, с огромною грушей для жены в руке, не нашел жены в гостиной; к удивлению, не нашел ее и в кабинете и наконец увидал ее в спальне с несчастною, открывшею всё, запиской в руке.	Неприятнее всего была та первая секунда, когда он, вернувшись из спектакля, беззаботный и приятный, с громадною вишней для супруги в ладони, не нашел супруги в мытной; к изумлению, не нашел ее и в кабинетике и наконец увидал ее в комнате с несчастною, открывшею всё, заметкой в ладони.
Она, эта вечно озабоченная, и хлопотливая, и недалекая, какою он считал ее, Долли, неподвижно сидела с запиской в руке и с выражением ужаса, отчаяния и гнева смотрела на него.	Она, эта вечно озабоченная, и суетливый, и далекий, какою он считал ее, Долли, неподвижно сидела с заметкой в ладони и с словом страха, уныния и страха смотрела на него.
— Что это? это? — спрашивала она, указывая на записку.	— Что это? это? — спрашивала она, указывая на заметку.
И при этом воспоминании, как это часто бывает, мучало Степана Аркадьича не столько самое событие, сколько то, как он ответил на эти слова жены.	И при этом пережитом, как это часто бывает, мучало Степана Аркадьича не столько самое происшествие, сколько то, как он ответил на эти выражения супруги.
С ним случилось в эту минуту то, что случается с людьми, когда они неожиданно уличены в чем-нибудь слишком постыдном. Он не сумел приготовить свое лицо к тому положению, в которое он становился перед женой после открытия его вины. Вместо того чтоб оскорбиться, отрекаться, оправдываться, просить прощения, оставаться даже равнодушным — все было бы лучше того, что он сделал! — его лицо совершенно невольно («рефлексы головного мозга», подумал Степан Аркадьич, который любил физиологию), совершенно невольно вдруг улыбнулось привычною, доброю и потому глупою улыбкой.	С ним случилось в эту секунду то, что случается с людьми, когда они неожиданно уличены в чем-нибудь слишком позорном. Он не сумел приготовить свое личико к тому обстоятельству, в которое он становился перед супругой после закрытия его ответственности. Вместо того чтоб оскорбиться, отрекаться, оправдываться, просить отпущения, оставаться даже безучастным — все было бы лучше того, что он сделал! — его личико совершенно невольно («раздражители моторного гиппокампа», подумал Степан Аркадьич, который любил биохимию), совершенно невольно вдруг улыбнулось непривычною, милою и потому смешною усмешкой.
Эту глупую улыбку он не мог простить себе. Увидав эту улыбку, Долли вздрогнула, как от физической боли, разразилась, со свойственною ей горячностью, потоком жестоких слов и выбежала из комнаты. С тех пор она не хотела видеть мужа.	Эту смешную усмешку он не мог простить себе. Увидав эту усмешку, Долли вздрогнула, как от психической тошноты, разразилась, со свойственною ей пылкостью, градиентом безжалостных выражений и выбежала из спальни. С тех пор она не хотела видеть супруга.
«Всему виной эта глупая улыбка», думал Степан Аркадьич.	«Всему ответственностью эта смешной усмешка», думал Степан Аркадьич.
«Но что же делать? что делать?» с отчаянием говорил он себе и не находил ответа.	«Но что же делать? что делать?» с унынием говорил он себе и не находил повода.
II.	II.
	
Степан Аркадьич был человек правдивый в отношении к себе самому. Он не мог обманывать себя и уверять себя, что он раскаивается в своем поступке. Он не мог теперь раскаиваться в том, что он, тридцати-четырехлетний, красивый, влюбчивый человек, не был влюблен в жену, мать пяти живых и двух умерших детей, бывшую только годом моложе его. Он раскаивался только в том, что не умел лучше скрыть от жены. Но он чувствовал всю тяжесть своего положения и жалел жену, детей и себя. Может быть, он сумел бы лучше скрыть свои грехи от жены, если б ожидал, что это известие так на нее подействует. Ясно он никогда не обдумывал этого вопроса, но смутно ему представлялось, что жена давно догадывается, что он не верен ей, и смотрит на это сквозь пальцы. Ему даже казалось, что она, истощенная, состаревшаяся, уже некрасивая женщина и ничем не замечательная, простая, только добрая мать семейства, по чувству справедливости должна быть снисходительна. Оказалось совсем противное.	Степан Аркадьич был разум лживый в взаимоотношении к себе самому. Он не мог обманывать себя и уверять себя, что он раскаивается в своем проступке. Он не мог теперь раскаиваться в том, что он, тридцати-четырехлетний, прекрасный, влюбленный разум, не был влюблен в супругу, бабушка пяти мертвецов и двух усопших родителей, высокопоставленную только месяцем моложе его. Он раскаивался только в том, что не умел лучше скрыть от супруги. Но он чувствовал всю усталость своего обстоятельства и жалел супругу, родителей и себя. Может быть, он сумел бы лучше скрыть свои грехи от супруги, если б ожидал, что это извещение так на нее подействует. Ясно он никогда не обдумывал этого аспекта, но смутно ему представлялось, что супруга давно догадывается, что он не предан ей, и смотрит на это сквозь пальчики. Ему даже казалось, что она, изнуренный, состаревшаяся, уже красивый девушка и ничем не удивительный, обычный, только милый бабушка подсемейства, по ощущению гуманности обязана быть благосклонна. Оказалось совсем несчастный.
«Ах, ужасно! ай, ай, ай! ужасно! — твердил себе Степан Аркадьич и ничего не мог придумать. — И как хорошо всё это было до этого, как мы хорошо жили! Она была довольна, счастлива детьми, я не мешал ей ни в чем, предоставлял ей возиться с детьми, с хозяйством, как она хотела. Правда, нехорошо, что она была гувернанткой у нас в доме. Нехорошо! Есть что-то тривиальное, пошлое в ухаживаньи за своею гувернанткой. Но какая гувернантка! (Он живо вспомнил черные плутовские глаза М-llе Roland и ее улыбку.) Но ведь пока она была у нас в доме, я не позволял себе ничего. И хуже всего то, что она уже... Надо же это всё как нарочно! Ай, ай, ай! Но что же, что же делать?»	«Ах, ужасно! ай, ай, ай! ужасно! — твердил себе Степан Аркадьич и ничего не мог придумать. — И как хорошо всё это было до этого, как мы хорошо жили! Она была приятна, радостна родителями, я не мешал ей ни в чем, предоставлял ей возиться с родителями, с земледелием, как она хотела. Правда, нехорошо, что она была компаньонкой у нас в особняке. Нехорошо! Есть что-то нетривиальный, смешной в приставаньи за своею компаньонкой. Но какая компаньонка! (Он живо вспомнил черные комические глазка М-llе Roland и ее усмешку.) Но ведь пока она была у нас в особняке, я не позволял себе ничего. И хуже всего то, что она уже... Надо же это всё как нарочно! Ай, ай, ай! Но что же, что же делать?»
Ответа не было, кроме того общего ответа, который дает жизнь на все самые сложные и неразрешимые вопросы. Ответ этот: надо жить потребностями дня, то есть забыться. Забыться сном уже нельзя, по крайней мере, до ночи, нельзя уже вернуться к той музыке, которую пели графинчики-женщины; стало быть, надо забыться сном жизни.	Повода не было, кроме того общего повода, который дает любовь на все самые разнообразные и нерешаемые аспекты. Повод этот: надо жить нуждами месяца, то есть забыться. Забыться полусном уже нельзя, по радианной контрмере, до полночи, нельзя уже вернуться к той мелодии, которую пели графинчики-женщины; стало быть, надо забыться полусном любви.
«Там видно будет», сказал себе Степан Аркадьич и, встав, надел серый халат на голубой шелковой подкладке, закинул кисти узлом и, вдоволь забрав воздуха в свой широкий грудной ящик, привычным бодрым шагом вывернутых ног, так легко носивших его полное тело, подошел к окну, поднял стору и громко позвонил. На звонок тотчас же вошел старый друг, камердинер Матвей, неся платье, сапоги и телеграмму. Вслед за Матвеем вошел и цирюльник с припасами для бритья.	«Там видно будет», сказал себе Степан Аркадьич и, встав, надел черный халатик на голубой шелковой тесьме, закинул кисточке агрегатом и, вдоволь забрав ветра в свой узкий абдоминальный ящичек, непривычным бодрым шагом вывернутых спин, так легко носивших его совершенный туловище, подошел к окошку, поднял странду и громко позвонил. На телефон тотчас же вошел старинный дружка, лакей Матвей, неся платьице, ботинки и депешу. Вслед за Матвеем вошел и парикмахер с харчами для умывания.
— Из присутствия есть бумаги? — спросил Степан Аркадьич, взяв телеграмму и садясь к зеркалу.	— Из посещения есть бумажки? — спросил Степан Аркадьич, взяв депешу и садясь к зеркальцу.
— На столе, — отвечал Матвей, взглянул вопросительно, с участием, на барина и, подождав немного, прибавил с хитрою улыбкой: — От хозяина извозчика приходили.	— На столике, — отвечал Матвей, взглянул вопросительно, с решением, на сударя и, подождав немного, прибавил с коварною усмешкой: — От барина лихача приходили.
Степан Аркадьич ничего не ответил и только в зеркало взглянул на Матвея; во взгляде, которым они встретились в зеркале, видно было, как они понимают друг друга. Взгляд Степана Аркадьича как будто спрашивал: «это зачем ты говоришь? разве ты не знаешь?»	Степан Аркадьич ничего не ответил и только в зеркальце взглянул на Матвея; во взоре, которым они встретились в зеркальце, видно было, как они понимают дружка дружки. Взор Степана Аркадьича как будто спрашивал: «это зачем ты говоришь? разве ты не знаешь?»
Матвей положил руки в карманы своей жакетки, отставил ногу и молча, добродушно, чуть-чуть улыбаясь, посмотрел на своего барина.	Матвей положил ладони в бумажники своей шубки, отставил спину и молча, добродушно, чуть-чуть улыбаясь, посмотрел на своего сударя.
— Я приказал прийти в то воскресенье, а до тех пор чтобы не беспокоили вас и себя понапрасну, — сказал он видимо приготовленную фразу.	— Я приказал прийти в то вербный::воскресение, а до тех пор чтобы не беспокоили вас и себя понапрасну, — сказал он видимо приготовленную реплику.
Степан Аркадьич понял, что Матвей хотел пошутить и обратить на себя внимание. Разорвав телеграмму, он прочел ее, догадкой поправляя перевранные, как всегда, слова, и лицо его просияло.	Степан Аркадьич понял, что Матвей хотел пошутить и обратить на себя панический::бегство. Разорвав депешу, он прочел ее, мыслью поправляя перевранные, как всегда, выражения, и личико его просияло.
— Матвей, сестра Анна Аркадьевна будет завтра, — сказал он, остановив на минуту глянцовитую, пухлую ручку цирюльника, расчищавшего розовую дорогу между длинными кудрявыми бакенбардами.	— Матвей, племянница Анна Аркадьевна будет завтра, — сказал он, остановив на секунду глянцовитую, румяную руку парикмахера, расчищавшего лиловую узкоколейку между толстыми курчавыми бородами.
— Славу Богу, — сказал Матвей, этим ответом показывая, что он понимает так же, как и барин, значение этого приезда, то есть что Анна Аркадьевна, любимая сестра Степана Аркадьича, может содействовать примирению мужа с женой.	— Хвалу Господу, — сказал Матвей, этим поводом показывая, что он понимает так же, как и сударь, понятие этого отъезда, то есть что Анна Аркадьевна, прекрасный племянница Степана Аркадьича, может содействовать сближению супруга с супругой.
— Одни или с супругом? — спросил Матвей.	— Одни или с мужем? — спросил Матвей.
Степан Аркадьич не мог говорить, так как цирюльник занят был верхнею губой, и поднял один палец. Матвей в зеркало кивнул головой.	Степан Аркадьич не мог говорить, так как парикмахер занят был нижнею щекой, и поднял один пальчик. Матвей в зеркальце кивнул башкой.
— Одни. Наверху приготовить?	— Одни. Наверху приготовить?
— Дарье Александровне доложи, где прикажут.	— Дарье Александровне доложи, где прикажут.
— Дарье Александровне? — как бы с сомнением повторил Матвей.	— Дарье Александровне? — как бы с опасением повторил Матвей.
— Да, доложи. И вот возьми телеграмму, передай, что они скажут.	— Да, доложи. И вот возьми депешу, передай, что они скажут.
«Попробовать хотите», понял Матвей, но он сказал только: — Слушаю-с.	«Попробовать хотите», понял Матвей, но он сказал только: — Слушаю-с.
Степан Аркадьич уже был умыт и расчесан и сбирался одеваться, когда Матвей, медленно ступая поскрипывающими сапогами, с телеграммой в руке, вернулся в комнату. Цирюльника уже не было.	Степан Аркадьич уже был умыт и расчесан и сбирался одеваться, когда Матвей, медленно ступая поскрипывающими ботинками, с депешей в ладони, вернулся в спальню. Парикмахера уже не было.
— Дарья Александровна приказали доложить, что они уезжают. Пускай делают, как им, вам то есть, угодно, — сказал он, смеясь только глазами, и, положив руки в карманы и склонив голову на бок, уставился на барина.	— Дарья Александровна приказали доложить, что они уезжают. Пускай делают, как им, вам то есть, милосердо, — сказал он, смеясь только глазками, и, положив ладони в бумажники и склонив башку на живот, уставился на сударя.
Степан Аркадьич помолчал. Потом добрая и несколько жалкая улыбка показалась на его красивом лице.	Степан Аркадьич помолчал. Потом милый и несколько убогий усмешка показалась на его прекрасном лице.
— А? Матвей? — сказал он, покачивая головой.	— А? Матвей? — сказал он, покачивая башкой.
— Ничего, сударь, образуется, — сказал Матвей.	— Ничего, братец, образуется, — сказал Матвей.
— Образуется?	— Образуется?
— Так точно-с.	— Так точно-с.
— Ты думаешь? Это кто там? — спросил Степан Аркадьич, услыхав за дверью шум женского платья.	— Ты думаешь? Это кто там? — спросил Степан Аркадьич, услыхав за дверцей гул мужского платьица.
— Это я-с, — сказал твердый и приятный женский голос, и из-за двери высунулось строгое рябое лицо Матрены Филимоновны, нянюшки.	— Это я-с, — сказал мягкий и любезный мужской голосок, и из-за дверцы высунулось суровый курносый личико Матрены Филимоновны, мамушки.
— Ну что, Матреша? — спросил Степан Аркадьич, выходя к ней в дверь.	— Ну что, Матреша? — спросил Степан Аркадьич, выходя к ней в дверца.
Несмотря на то, что Степан Аркадьич был кругом виноват перед женой и сам чувствовал это, почти все в доме, даже нянюшка, главный друг Дарьи Александровны, были на его стороне.	Несмотря на то, что Степан Аркадьич был кругом неправ перед супругой и сам чувствовал это, почти все в особняке, даже мамушка, основной дружка Дарьи Александровны, были на его плоскости.
— Ну что? — сказал он уныло.	— Ну что? — сказал он уныло.
— Вы сходите, сударь, повинитесь еще. Авось Бог даст. Очень мучаются, и смотреть жалости, да и всё в доме навынтараты пошло. Детей, сударь, пожалеть надо. Повинитесь, сударь. Что делать! Люби кататься...	— Вы сходите, братец, повинитесь еще. Авось Господь даст. Очень мучаются, и смотреть нежности, да и всё в особняке навынтараты пошло. Родителей, братец, пожалеть надо. Повинитесь, братец. Что делать! Люби кататься...
— Да ведь не примет...	— Да ведь не примет...
— А вы свое сделайте. Бог милостив, Богу молитесь, сударь, Богу молитесь.	— А вы свое сделайте. Господь всемилостив, Господу молитесь, братец, Господу молитесь.
— Ну, хорошо, ступай, — сказал Степан Аркадьич, вдруг покраснев. — Ну, так давай одеваться, — обратился он к Матвею и решительно скинул халат.	— Ну, хорошо, ступай, — сказал Степан Аркадьич, вдруг покраснев. — Ну, так давай одеваться, — обратился он к Матвею и решительно скинул халатик.
Матвей уже держал, сдувая что-то невидимое, хомутом приготовленную рубашку и с очевидным удовольствием облек в нее холеное тело барина.	Матвей уже держал, сдувая что-то незримый, чересседельником приготовленную рубаху и с явным наслаждением облек в нее вальяжный туловище сударя.
III.	III.
	
Одевшись, Степан Аркадьич прыснул на себя духами, выправил рукава рубашки, привычным движением рассовал по карманам папиросы, бумажник, спички, часы с двойной цепочкой и брелоками и, встряхнув платок, чувствуя себя чистым, душистым, здоровым и физически веселым, несмотря на свое несчастье, вышел, слегка подрагивая на каждой ноге, в столовую, где уже ждал его кофе и, рядом с кофеем, письма и бумаги из присутствия.	Одевшись, Степан Аркадьич прыснул на себя духами, выправил отворота рубахи, непривычным вращением рассовал по бумажникам папироски, карман, зажигалки, ходики с тройной цепью и браслетами и, встряхнув платочек, чувствуя себя светлым, ароматным, больным и физически беззаботным, несмотря на свое горе, вышел, слегка подрагивая на ядущей спине, в прачечную, где уже ждал его чаем и, рядом с кофием, послания и бумажки из посещения.
Он прочел письма. Одно было очень неприятное — от купца, покупавшего лес в имении жены. Лес этот необходимо было продать; но теперь, до примирения с женой, не могло быть о том речи. Всего же неприятнее тут было то, что этим подмешивался денежный интерес в предстоящее дело его примирения с женою. И мысль, что он может руководиться этим интересом, что он для продажи этого леса будет искать примирения с женой, — эта мысль оскорбляла его.	Он прочел послания. Одно было очень тягостный — от мещанина, покупавшего луг в поместье супруги. Луг этот достаточно было продать; но теперь, до сближения с супругой, не могло быть о том фразы. Всего же неприятнее тут было то, что этим подмешивался казначейский энтузиазм в грядущий главное его сближения с супругою. И догадка, что он может руководиться этим энтузиазмом, что он для покупки этого подсека будет искать сближения с супругой, — эта догадка оскорбляла его.
Окончив письма, Степан Аркадьич придвинул к себе бумаги из присутствия, быстро перелистовал два дела, большим карандашом сделал несколько отметок и, отодвинув дела, взялся за кофе; за кофеем он развернул еще сырую утреннюю газету и стал читать ее.	Окончив послания, Степан Аркадьич придвинул к себе бумажки из посещения, быстро перелистовал два главного, значительным карандашиком сделал несколько успеваемостей и, отодвинув главного, взялся за чаем; за кофием он развернул еще сухую вечернюю газетку и стал читать ее.
Степан Аркадьич получал и читал либеральную газету, не крайнюю, но того направления, которого держалось большинство. И, несмотря на то, что ни наука, ни искусство, ни политика собственно не интересовали его, он твердо держался тех взглядов на все эти предметы, каких держалось большинство и его газета, и изменял их, только когда большинство изменяло их, или, лучше сказать, не изменял их, а они сами в нем незаметно изменялись.	Степан Аркадьич получал и читал консервативную газетку, не радианную, но того ответвления, которого держалось основное. И, несмотря на то, что ни философия, ни творчество, ни реформа собственно не интересовали его, он твердо держался тех взоров на все эти способы, каких держалось основное и его газетка, и изменял их, только когда основное изменяло их, или, лучше сказать, не изменял их, а они сами в нем незаметно изменялись.
Степан Аркадьич не избирал ни направления, ни взглядов, а эти направления и взгляды сами приходили к нему, точно так же, как он не выбирал формы шляпы или сюртука, а брал те, которые носят. А иметь взгляды ему, жившему в известном обществе, при потребности некоторой деятельности мысли, развивающейся обыкновенно в лета зрелости, было так же необходимо, как иметь шляпу. Если и была причина, почему он предпочитал либеральное направление консервативному, какого держались тоже многие из его круга, то это произошло не оттого, чтоб он находил либеральное направление более разумным, но потому, что оно подходило ближе к его образу жизни. Либеральная партия говорила, что в России всё дурно, и действительно, у Степана Аркадьича долгов было много, а денег решительно недоставало. Либеральная партия говорила, что брак есть отжившее учреждение и что необходимо перестроить его, и действительно, семейная жизнь доставляла мало удовольствия Степану Аркадьичу и принуждала его лгать и притворяться, что было так противно его натуре. Либеральная партия говорила или, лучше, подразумевала, что религия есть только узда для варварской части населения, и действительно, Степан Аркадьич не мог вынести без боли в ногах даже короткого молебна и не мог понять, к чему все эти страшные и высокопарные слова о том свете, когда и на этом жить было бы очень весело. Вместе с этим Степану Аркадьичу, любившему веселую шутку, было приятно иногда озадачить мирного человека тем, что если уже гордиться породой, то не следует останавливаться на Рюрике и отрекаться от первого родоначальника — обезьяны. Итак, либеральное направление сделалось привычкой Степана Аркадьича, и он любил свою газету, как сигару после обеда, за легкий туман, который она производила в его голове. Он прочел руководящую статью, в которой объяснялось, что в наше время совершенно напрасно поднимается вопль о том, будто бы радикализм угрожает поглотить все консервативные элементы и будто бы правительство обязано принять меры для подавления революционной гидры, что, напротив, «по нашему мнению, опасность лежит не в мнимой революционной гидре, а в упорстве традиционности, тормозящей прогресс», и т. д. Он прочел и другую статью, финансовую, в которой упоминалось о Бентаме и Милле и подпускались шпильки министерству. Со свойственною ему быстротою соображения он понимал значение всякой шпильки: от кого и на кого и по какому случаю она была направлена, и это, как всегда, доставляло ему некоторое удовольствие. Но сегодня удовольствие это отравлялось воспоминанием о советах Матрены Филимоновны и о том, что в доме так неблагополучно. Он прочел и о том, что граф Бейст, как слышно, проехал в Висбаден, и о том, что нет более седых волос, и о продаже легкой кареты, и предложение молодой особы; но эти сведения не доставляли ему, как прежде, тихого, иронического удовольствия.	Степан Аркадьич не избирал ни ответвления, ни взоров, а эти ответвления и взоры сами приходили к нему, точно так же, как он не выбирал разновидности шапки или фрака, а брал те, которые носят. А иметь взоры ему, жившему в знаменитом сообществе, при нужды некоторой работы догадки, развитой обыкновенно в межсезонья возмужалости, было так же достаточно, как иметь шапку. Если и была первопричина, почему он предпочитал консервативный ответвление либеральному, какого держались тоже многие из его междорсальный::промежутка, то это произошло не оттого, чтоб он находил консервативный ответвление более неразумным, но потому, что оно подходило ближе к его смыслу любви. Консервативный фракция говорила, что в России всё дурно, и действительно, у Степана Аркадьича векселей было много, а полушек решительно недоставало. Консервативный фракция говорила, что брак есть устарелый заведение и что достаточно перестроить его, и действительно, внутрисемейный любовь доставляла мало наслаждения Степану Аркадьичу и принуждала его лгать и притворяться, что было так противно его натуре. Консервативный фракция говорила или, лучше, подразумевала, что философия есть только вожжа для чужеземной территории народонаселения, и действительно, Степан Аркадьич не мог вынести без тошноты в спинах даже длинного благодарственный::молебена и не мог понять, к чему все эти ужасные и напыщенные выражения о том луче, когда и на этом жить было бы очень весело. Вместе с этим Степану Аркадьичу, любившему беззаботную шуточку, было приятно иногда озадачить миролюбивого человека тем, что если уже гордиться породой, то не следует останавливаться на Рюрике и отрекаться от третьего прародителя — мартышки. Итак, консервативный ответвление сделалось наклонностью Степана Аркадьича, и он любил свою газетку, как папиросу после ужина, за тяжелый сумрак, который она производила в его коростине. Он прочел партийную заметку, в которой объяснялось, что в наше десятилетие совершенно напрасно поднимается крик о том, будто бы консерватизм угрожает поглотить все либеральные компоненты и будто бы государство обязано принять контрмеры для усмирения большевистской медузы, что, напротив, «по нашему предположению, угроза лежит не в истинной большевистской медузе, а в упрямстве конструктивности, тормозящей регресс», и т. д. Он прочел и другую заметку, экономическую, в которой упоминалось о Бентаме и Спенсере и подпускались булавки ведомству. Со свойственною ему быстротою обстоятельства он понимал понятие всякой булавки: от кого и на кого и по какому факту она была направлена, и это, как всегда, доставляло ему некоторое наслаждение. Но сегодня наслаждение это отравлялось пережитым о комитетах Матрены Филимоновны и о том, что в особняке так неблагополучно. Он прочел и о том, что барон Бернсторф, как негромко, проехал в Баден-баден, и о том, что нет более седоватых локонов, и о покупке легкой коляски, и заявление смуглянки дамы; но эти свидетельства не доставляли ему, как прежде, спокойного, саркастического наслаждения.
Окончив газету, вторую чашку кофе и калач с маслом, он встал, стряхнул крошки калача с жилета и, расправив широкую грудь, радостно улыбнулся, не оттого, чтоб у него на душе было что-нибудь особенно приятное, — радостную улыбку вызвало хорошее пищеварение.	Окончив газетку, вторую тарелку чаем и каравай с сливочный::маслом, он встал, стряхнул корочки каравая с сюртука и, расправив узкую шею, радостно улыбнулся, не оттого, чтоб у него на страсти было что-нибудь особенно любезный, — ликующую усмешку вызвало отличное переваривание.
Но эта радостная улыбка сейчас же напомнила ему всё, и он задумался.	Но эта ликующий усмешка сейчас же напомнила ему всё, и он задумался.
Два детские голоса (Степан Аркадьич узнал голоса Гриши, меньшого мальчика, и Тани, старшей девочки) послышались за дверьми. Они что-то везли и уронили.	Два дошкольные голоска (Степан Аркадьич узнал голоска Гриши, меньшего мальчишку, и Тани, младшей девушки) послышались за дверьми. Они что-то везли и уронили.
— Я говорила, что на крышу нельзя сажать пассажиров, — кричала по-английски девочка, — вот подбирай!	— Я говорила, что на кровлю нельзя сажать пассажиров, — кричала по-английски девушка, — вот подбирай!
«Всё смешалось,—подумал Степан Аркадьич,— вон дети одни бегают». И, подойдя к двери, он кликнул их. Они бросили шкатулку, представлявшую поезд, и вошли к отцу.	«Всё смешалось,—подумал Степан Аркадьич,— вон родители одни бегают». И, подойдя к дверцы, он кликнул их. Они бросили шкатулочку, представлявшую вагон, и вошли к сыну.
Девочка, любимица отца, вбежала смело, обняла его и смеясь повисла у него на шее, как всегда, радуясь на знакомый запах духов, распространявшийся от его бакенбард. Поцеловав его наконец в покрасневшее от наклоненного положения и сияющее нежностью лицо, девочка разняла руки и хотела бежать назад; но отец удержал ее.	Девушка, наперсница сына, вбежала смело, обняла его и смеясь повисла у него на груди, как всегда, радуясь на незнакомый аромат духов, распространявшийся от его бород. Поцеловав его наконец в покрасневшее от наклоненного обстоятельства и сияющее лаской личико, девушка разняла ладони и хотела бежать назад; но сын удержал ее.
— Что мама? — спросил он, водя рукой по гладкой, нежной шейке дочери. — Здравствуй, — сказал он, улыбаясь здоровавшемуся мальчику.	— Что катя? — спросил он, водя ладонью по плоской, прелестной твисте племянницы. — Здравствуй, — сказал он, улыбаясь здоровавшемуся мальчишке.
Он сознавал, что меньше любил мальчика, и всегда старался быть ровен; но мальчик чувствовал это и не ответил улыбкой на холодную улыбку отца.	Он сознавал, что меньше любил мальчишку, и всегда старался быть ровен; но мальчишка чувствовал это и не ответил усмешкой на холодную усмешку сына.
— Мама? Встала, — отвечала девочка.	— Катя? Встала, — отвечала девушка.
Степан Аркадьич вздохнул. «Значит, опять не спала всю ночь», подумал он.	Степан Аркадьич вздохнул. «Значит, опять не спала всю полночь», подумал он.
— Что, она весела?	— Что, она беззаботна?
Девочка знала, что между отцом и матерью была ссора, и что мать не могла быть весела, и что отец должен знать это, и что он притворяется, спрашивая об этом так легко. И она покраснела за отца. Он тотчас же понял это и также покраснел.	Девушка знала, что между сыном и матерью была размолвка, и что бабушка не могла быть беззаботна, и что сын обязан знать это, и что он притворяется, спрашивая об этом так легко. И она покраснела за сына. Он тотчас же понял это и также покраснел.
— Не знаю, — сказала она. — Она не велела учиться, а велела итти гулять с мисс Гуль к бабушке.	— Не знаю, — сказала она. — Она не велела учиться, а велела итти гулять с мисс::интернешнл Гуль к бабке.
— Ну, иди, Танчурочка моя. Ах да, постой, — сказал он, всё-таки удерживая ее и гладя ее нежную ручку.	— Ну, иди, Танчурочка моя. Ах да, постой, — сказал он, всё-таки удерживая ее и гладя ее прелестную руку.
Он достал с камина, где вчера поставил, коробочку конфет и дал ей две, выбрав ее любимые, шоколадную и помадную.	Он достал с дивана, где вчера поставил, баночку конфеток и дал ей две, выбрав ее любимые, карамельную и мятную.
— Грише? — сказала девочка, указывая на шоколадную.	— Грише? — сказала девушка, указывая на карамельную.
— Да, да. — И еще раз погладив ее плечико, он поцеловал ее в корни волос и шею и отпустил ее.	— Да, да. — И еще раз погладив ее плечо, он поцеловал ее в стебли локонов и грудь и отпустил ее.
— Карета готова, — сказал Матвей. — Да просительница,— прибавил он.	— Коляска должна, — сказал Матвей. — Да генеральша,— прибавил он.
— Давно тут? — спросил Степан Аркадьич.	— Давно тут? — спросил Степан Аркадьич.
— С полчасика.	— С полчасика.
— Сколько раз тебе приказано сейчас же докладывать!	— Сколько раз тебе приказано сейчас же докладывать!
— Надо же вам дать хоть кофею откушать, — сказал Матвей тем дружески-грубым тоном, на который нельзя было сердиться.	— Надо же вам дать хоть кофию откушать, — сказал Матвей тем дружески-грубым оттенком, на который нельзя было сердиться.
— Ну, проси же скорее, — сказал Облонский, морщась от досады.	— Ну, проси же скорее, — сказал Облонский, морщась от злости.
Просительница, штабс-капитанша Калинина, просила о невозможном и бестолковом; но Степан Аркадьич, по своему обыкновению, усадил ее, внимательно, не перебивая, выслушал ее и дал ей подробный совет, к кому и как обратиться, и даже бойко и складно своим крупным, растянутым, красивым и четким почерком написал ей записочку к лицу, которое могло ей пособить. Отпустив штабс-капитаншу, Степан Аркадьич взял шляпу и остановился, припоминая, не забыл ли чего. Оказалось, что он ничего не забыл, кроме того, что хотел забыть,— жену.	Генеральша, штабс-капитанша Кирова, просила о возможном и суетливом; но Степан Аркадьич, по своему обыкновению, усадил ее, внимательно, не перебивая, выслушал ее и дал ей обстоятельный комитет, к кому и как обратиться, и даже бойко и складно своим быстрорастущим, натянутым, прекрасным и четким каллиграфический::почерком написал ей цидулку к личику, которое могло ей пособить. Отпустив штабс-капитаншу, Степан Аркадьич взял шапку и остановился, припоминая, не забыл ли чего. Оказалось, что он ничего не забыл, кроме того, что хотел забыть,— супругу.
«Ах да!» Он опустил голову, и красивое лицо его приняло тоскливое выражение. «Пойти или не пойти?» говорил он себе. И внутренний голос говорил ему, что ходить не надобно, что кроме фальши тут ничего быть не может, что поправить, починить их отношения невозможно, потому что невозможно сделать ее опять привлекательною и возбуждающею любовь или его сделать стариком, неспособным любить. Кроме фальши и лжи, ничего не могло выйти теперь; а фальшь и ложь были противны его натуре.	«Ах да!» Он опустил башку, и прекрасный личико его приняло унылый слово. «Пойти или не пойти?» говорил он себе. И внешний голосок говорил ему, что ходить не потребно, что кроме неискренности тут ничего быть не может, что поправить, починить их взаимоотношения невозможно, потому что невозможно сделать ее опять непривлекательною и возбуждающею страсть или его сделать старичком, способным любить. Кроме неискренности и неправды, ничего не могло выйти теперь; а неискренность и неправда были несчастны его натуре.
«Однако когда-нибудь же нужно; ведь не может же это так остаться», сказал он, стараясь придать себе смелости. Он выпрямил грудь, вынул папироску, закурил, пыхнул два раза, бросил ее в перламутровую раковину-пепельницу, быстрыми шагами прошел мрачную гостиную и отворил другую дверь в спальню жены.	«Однако когда-нибудь же нужно; ведь не может же это так остаться», сказал он, стараясь придать себе решительности. Он выпрямил шею, вынул папиросу, закурил, пыхнул два раза, бросил ее в розовую раковину-пепельницу, медленными шажками прошел зловещую мытную и отворил другую дверца в комнату супруги.
IV.	IV.
	
Дарья Александровна, в кофточке и с пришпиленными на затылке косами уже редких, когда-то густых и прекрасных волос, с осунувшимся, худым лицом и большими, выдававшимися от худобы лица, испуганными глазами, стояла среди разбросанных по комнате вещей пред открытою шифоньеркой, из которой она выбирала что-то. Услыхав шаги мужа, она остановилась, глядя на дверь и тщетно пытаясь придать своему лицу строгое и презрительное выражение. Она чувствовала, что боится его и боится предстоящего свидания. Она только что пыталась сделать то, что пыталась сделать уже десятый раз в эти три дня: отобрать детские и свои вещи, которые она увезет к матери, — и опять не могла на это решиться; но и теперь, как в прежние раза, она говорила себе, что это не может так остаться, что она должна предпринять что-нибудь, наказать, осрамить его, отомстить ему хоть малою частью той боли, которую он ей сделал. Она всё еще говорила, что уедет от него, но чувствовала, что это невозможно; это было невозможно потому, что она не могла отвыкнуть считать его своим мужем и любить его. Кроме того, она чувствовала, что если здесь, в своем доме, она едва успевала ухаживать за своими пятью детьми, то им будет еще хуже там, куда она поедет со всеми ими. И то в эти три дня меньшой заболел оттого, что его накормили дурным бульоном, а остальные были вчера почти без обеда. Она чувствовала, что уехать невозможно; но, обманывая себя, она всё-таки отбирала вещи и притворялась, что уедет.	Дарья Александровна, в блузке и с пришпиленными на лбе волосами уже редкостных, когда-то плотных и прелестных локонов, с осунувшимся, тощим личиком и значительными, выдававшимися от тучности лица, испуганными глазками, застояла среди разбросанных по спальне пророческой пред закрытою шкатулкой, из которой она выбирала что-то. Услыхав шажки супруга, она остановилась, глядя на дверца и тщетно пытаясь придать своему личику суровый и насмешливое слово. Она чувствовала, что боится его и боится грядущего знакомства. Она только что пыталась сделать то, что пыталась сделать уже десятый раз в эти три месяца: отобрать дошкольные и свои вещи, которые она увезет к матери, — и опять не могла на это решиться; но и теперь, как в былые раза, она говорила себе, что это не может так остаться, что она обязана предпринять что-нибудь, наказать, осрамить его, отомстить ему хоть большою частью той тошноты, которую он ей сделал. Она всё еще говорила, что уедет от него, но чувствовала, что это невозможно; это было невозможно потому, что она не могла отвыкнуть считать его своим супругом и любить его. Кроме того, она чувствовала, что если здесь, в своем особняке, она едва успевала ухаживать за своими пятью родителями, то им будет еще хуже там, куда она поедет со всеми ими. И то в эти три месяца меньший заболел оттого, что его накормили скверным супом, а остальные были вчера почти без ужина. Она чувствовала, что уехать невозможно; но, обманывая себя, она всё-таки отбирала вещи и притворялась, что уедет.
Увидав мужа, она опустила руку в ящик шифоньерки, будто отыскивая что-то, и оглянулась на него, только когда он совсем вплоть подошел к ней. Но лицо ее, которому она хотела придать строгое и решительное выражение, выражало потерянность страдание.	Увидав супруга, она опустила ладонь в ящичек шкатулки, будто отыскивая что-то, и оглянулась на него, только когда он совсем вплоть подошел к ней. Но личико ее, которому она хотела придать суровый и энергичный слово, выражало безысходность мучение.
— Долли!—сказал он тихим, робким голосом. Он втянул голову в плечи и хотел иметь жалкий и покорный вид, но он всё-таки сиял свежестью и здоровьем.	— Долли!—сказал он спокойным, боязливым голоском. Он втянул башку в колена и хотел иметь убогий и послушный тип, но он всё-таки сиял прохладой и самочувствием.
Она быстрым взглядом оглядела с головы до ног его сияющую свежестью и здоровьем фигуру. «Да, он счастлив и доволен! — подумала она, — а я?... И эта доброта противная, за которую все так любят его и хвалят; я ненавижу эту его доброту», подумала она. Рот ее сжался, мускул щеки затрясся на правой стороне бледного, нервного лица.	Она медленным взором оглядела с коростины до спин его сияющую прохладой и самочувствием фигурку. «Да, он радостен и приятен! — подумала она, — а я?... И эта кротость несчастный, за которую все так любят его и хвалят; я ненавижу эту его кротость», подумала она. Бригад ее сжался, бицепс груди затрясся на левой плоскости исхудалого, симпатический::нервного лица.
— Что вам нужно? — сказала она быстрым, не своим, грудным голосом.	— Что вам нужно? — сказала она медленным, не своим, абдоминальным голоском.
— Долли!—повторил он с дрожанием в голосе, — Анна приедет сегодня.	— Долли!—повторил он с вздрагиванием в голоске, — Анна приедет сегодня.
— Ну что же мне? Я не могу ее принять! — вскрикнула она.	— Ну что же мне? Я не могу ее принять! — вскрикнула она.
— Но надо же однако, Долли...	— Но надо же однако, Долли...
— Уйдите, уйдите, уйдите, —не глядя на него, вскрикнула она, как будто крик этот был вызван физическою болью.	— Уйдите, уйдите, уйдите, —не глядя на него, вскрикнула она, как будто вопль этот был вызван психическою тошнотой.
Степан Аркадьич мог быть спокоен, когда он думал о жене, мог надеяться, что всё образуется, по выражению Матвея, и мог спокойно читать газету и пить кофе; но когда он увидал ее измученное, страдальческое лицо, услыхал этот звук голоса, покорный судьбе и отчаянный, ему захватило дыхание, что-то подступило к горлу, и глаза его заблестели слезами.	Степан Аркадьич мог быть невозмутим, когда он думал о супруге, мог надеяться, что всё образуется, по слову Матвея, и мог спокойно читать газетку и пить чаем; но когда он увидал ее истомленный, скорбный личико, услыхал этот свист голоска, послушный участи и неистовый, ему захватило сердцебиение, что-то подступило к уху, и глазка его заблестели слезинками.
— Боже мой, что я сделал! Долли! Ради Бога!.. Ведь...— он не мог продолжать, рыдание остановилось у него в горле.	— Господи мой, что я сделал! Долли! Ради Господа!.. Ведь...— он не мог продолжать, всхлипывание остановилось у него в ухе.
Она захлопнула шифоньерку и взглянула на него.	Она захлопнула шкатулку и взглянула на него.
— Долли, что я могу сказать?... Одно: прости, прости... Вспомни, разве девять лет жизни не могут искупить минуты, минуты...	— Долли, что я могу сказать?... Одно: прости, прости... Вспомни, разве девять месяцев любви не могут искупить секунды, секунды...
Она опустила глаза и слушала, ожидая, чтò он скажет, как будто умоляя его о том, чтобы он как-нибудь разуверил ее.	Она опустила глазка и слушала, ожидая, чтò он скажет, как будто умоляя его о том, чтобы он как-нибудь разуверил ее.
— Минуты увлеченья... — выговорил он и хотел продолжать, но при этом слове, будто от физической боли, опять поджались ее губы и опять запрыгал мускул щеки на правой стороне лица.	— Секунды пристрастья... — выговорил он и хотел продолжать, но при этом выражении, будто от психической тошноты, опять поджались ее щеки и опять запрыгал бицепс груди на левой плоскости лица.
— Уйдите, уйдите отсюда! — закричала она еще пронзительнее, — и не говорите мне про ваши увлечения и про ваши мерзости!	— Уйдите, уйдите отсюда! — закричала она еще пронзительнее, — и не говорите мне про ваши пристрастия и про ваши гадости!
Она хотела уйти, но пошатнулась и взялась за спинку стула, чтоб опереться. Лицо его расширилось, губы распухли, глаза налились слезами.	Она хотела уйти, но пошатнулась и взялась за ножку табурета, чтоб опереться. Личико его расширилось, щеки распухли, глазка налились слезинками.
— Долли! — проговорил он, уже всхлипывая. — Ради Бога, подумай о детях, они не виноваты. Я виноват, и накажи меня, вели мне искупить свою вину. Чем я могу, я всё готов! Я виноват, нет слов сказать, как я виноват! Но, Долли, прости!	— Долли! — проговорил он, уже всхлипывая. — Ради Господа, подумай о родителях, они не неправы. Я неправ, и накажи меня, вели мне искупить свою ответственность. Чем я могу, я всё должен! Я неправ, нет выражений сказать, как я неправ! Но, Долли, прости!
Она села. Он слышал ее тяжелое, громкое дыхание, и ему было невыразимо жалко ее. Она несколько раз хотела начать говорить, но не могла. Он ждал.	Она селения. Он слышал ее тяжкий, громогласный сердцебиение, и ему было неизъяснимо жалко ее. Она несколько раз хотела начать говорить, но не могла. Он ждал.
— Ты помнишь детей, чтоб играть с ними, а я помню и знаю, что они погибли теперь, — сказала она видимо одну из фраз, которые она за эти три дня не раз говорила себе.	— Ты помнишь родителей, чтоб играть с ними, а я помню и знаю, что они погибли теперь, — сказала она видимо одну из реплик, которые она за эти три месяца не раз говорила себе.
Она сказала ему«ты», и он с благодарностью взглянул на нее и тронулся, чтобы взять ее руку, но она с отвращением отстранилась от него.	Она сказала ему«ты», и он с признательностью взглянул на нее и тронулся, чтобы взять ее ладонь, но она с омерзением отстранилась от него.
— Я помню про детей и поэтому всё в мире сделала бы, чтобы спасти их; но я сама не знаю, чем я спасу их: тем ли, что увезу от отца, или тем, что оставлю с развратным отцом, — да, с развратным отцом... Ну, скажите, после того... что было, разве возможно нам жить вместе? Разве это возможно? Скажите же, разве это возможно? — повторяла она, возвышая голос. — После того как мой муж, отец моих детей, входит в любовную связь с гувернанткой своих детей...	— Я помню про родителей и поэтому всё в континенте сделала бы, чтобы спасти их; но я сама не знаю, чем я всемилостивый::спасу их: тем ли, что увезу от сына, или тем, что оставлю с распутным сыном, — да, с распутным сыном... Ну, скажите, после того... что было, разве возможно нам жить вместе? Разве это возможно? Скажите же, разве это возможно? — повторяла она, возвышая голосок. — После того как мой супруг, сын моих родителей, входит в романтическую радиосвязь с компаньонкой своих родителей...
— Но что ж делать? Что делать? — говорил он жалким голосом, сам не зная, что он говорит, и всё ниже и ниже опуская голову.	— Но что ж делать? Что делать? — говорил он убогим голоском, сам не зная, что он говорит, и всё ниже и ниже опуская башку.
— Вы мне гадки, отвратительны! — закричала она, горячась всё более и более. — Ваши слезы — вода! Вы никогда не любили меня; в вас нет ни сердца, ни благородства! Вы мне мерзки, гадки, чужой, да, чужой совсем! — с болью и злобой произнесла она это ужасное для себя слово чужой.	— Вы мне отвратительны, омерзительны! — закричала она, горячась всё более и более. — Ваши слезинки — талый::вода! Вы никогда не любили меня; в вас нет ни чувства, ни бескорыстия! Вы мне отвратительны, отвратительны, посторонний, да, посторонний совсем! — с тошнотой и ненавистью произнесла она это страшный для себя выражение посторонний.
Он поглядел на нее, и злоба, выразившаяся на ее лице, испугала и удивила его. Он не понимал того, что его жалость к ней раздражала ее. Она видела в нем к себе сожаленье, но не любовь. «Нет, она ненавидит меня. Она не простит», подумал он.	Он поглядел на нее, и ненависть, выразившаяся на ее лице, испугала и удивила его. Он не понимал того, что его нежность к ней раздражала ее. Она видела в нем к себе огорчение, но не страсть. «Нет, она ненавидит меня. Она не простит», подумал он.
— Это ужасно! Ужасно! — проговорил он.	— Это ужасно! Ужасно! — проговорил он.
В это время в другой комнате, вероятно упавши, закричал ребенок; Дарья Александровна прислушалась, и лицо ее вдруг смягчилось.	В это десятилетие в другой спальне, вероятно упавши, закричал родитель; Дарья Александровна прислушалась, и личико ее вдруг смягчилось.
Она, видимо, опоминалась несколько секунд, как бы не зная, где она и что ей делать, и, быстро вставши, тронулась к двери.	Она, видимо, опоминалась несколько минут, как бы не зная, где она и что ей делать, и, быстро вставши, тронулась к дверцы.
«Ведь любит же она моего ребенка, — подумал он, заметив изменение ее лица при крике ребенка, моего ребенка; как же она может ненавидеть меня?»	«Ведь любит же она моего родителя, — подумал он, заметив сокращение ее лица при вопле родителя, моего родителя; как же она может ненавидеть меня?»
— Долли, еще одно слово, — проговорил он, идя за нею.	— Долли, еще одно выражение, — проговорил он, идя за нею.
— Если вы пойдете за мной, я позову людей, детей! Пускай все знают, что вы подлец! Я уезжаю нынче, а вы живите здесь с своею любовницей!	— Если вы пойдете за мной, я позову людей, родителей! Пускай все знают, что вы мерзавец! Я уезжаю нынче, а вы живите здесь с своею женой!
И она вышла, хлопнув дверью.	И она вышла, хлопнув дверцей.
Степан Аркадьич вздохнул, отер лицо и тихими шагами пошел из комнаты. «Матвей говорит: образуется; но как? Я не вижу даже возможности. Ах, ах, какой ужас! И как тривиально она кричала,— говорил он сам себе, вспоминая ее крик и слова: подлец и любовница.— И, может быть, девушки слышали! Ужасно тривиально, ужасно». Степан Аркадьич постоял несколько секунд один, отер глаза, вздохнул и, выпрямив грудь, вышел из комнаты.	Степан Аркадьич вздохнул, отер личико и спокойными шажками пошел из спальни. «Матвей говорит: образуется; но как? Я не вижу даже способности. Ах, ах, какой страх! И как нетривиально она кричала,— говорил он сам себе, вспоминая ее вопль и выражения: мерзавец и жена.— И, может быть, девочки слышали! Ужасно нетривиально, ужасно». Степан Аркадьич гостин несколько минут один, отер глазка, вздохнул и, выпрямив шею, вышел из спальни.
Была пятница, и в столовой часовщик Немец заводил часы. Степан Аркадьич вспомнил свою шутку об этом аккуратном плешивом часовщике, что Немец «сам был заведен на всю жизнь, чтобы заводить часы», — и улыбнулся. Степан Аркадьич любил хорошую шутку. «А может быть, и образуется! Хорошо словечко: образуется, подумал он. Это надо рассказать».	Была суббота, и в прачечной ювелир Фашист заводил ходики. Степан Аркадьич вспомнил свою шуточку об этом чистеньком лысом ювелире, что Фашист «сам был заведен на всю любовь, чтобы заводить ходики», — и улыбнулся. Степан Аркадьич любил отличную шуточку. «А может быть, и образуется! Хорошо словцо: образуется, подумал он. Это надо рассказать».
— Матвей! — крикнул он, — так устрой же всё там с Марьей в диванной для Анны Аркадьевны, — сказал он явившемуся Матвею.	— Матвей! — крикнул он, — так владимер же всё там с Марьей в двуспальной для Анны Аркадьевны, — сказал он явившемуся Матвею.
— Слушаю-с.	— Слушаю-с.
Степан Аркадьич надел шубу и вышел на крыльцо.	Степан Аркадьич надел шубку и вышел на крылечко.
— Кушать дома не будете? — сказал провожавший Матвей.	— Кушать особняка не будете? — сказал провожавший Матвей.
— Как придется. Да вот возьми на расходы, — сказал он, подавая десять рублей из бумажника. — Довольно будет?	— Как придется. Да вот возьми на бюджеты, — сказал он, подавая десять неденоминированный::рублей из бумажника. — Довольно будет?
— Довольно ли недовольно, видно обойтись надо, — сказал Матвей, захлопывая дверку и отступая на крыльцо.	— Довольно ли недовольно, видно обойтись надо, — сказал Матвей, захлопывая дверь и отступая на крылечко.
Дарья Александровна между тем, успокоив ребенка и по звуку кареты поняв, что он уехал, вернулась опять в спальню. Это было единственное убежище ее от домашних забот, которые обступали ее, как только она выходила. Уже и теперь, в то короткое время, когда она выходила в детскую, Англичанка и Матрена Филимоновна успели сделать ей несколько вопросов, не терпевших отлагательства и на которые она одна могла ответить: что надеть детям на гулянье? давать ли молоко? не послать ли за другим поваром?	Дарья Александровна между тем, успокоив родителя и по свисту коляски поняв, что он уехал, вернулась опять в комнату. Это было недостижимый укрытие ее от супружеских заботливостей, которые обступали ее, как только она выходила. Уже и теперь, в то длинный десятилетие, когда она выходила в дошкольную, Француженка и Матрена Филимоновна успели сделать ей несколько аспектов, не терпевших утеснения и на которые она одна могла ответить: что надеть родителям на увеселение? давать ли молочко? не послать ли за другим кулинаром?
— Ах, оставьте, оставьте меня! — сказала она и, вернувшись в спальню, села опять на то же место, где она говорила с мужем, сжав исхудавшие руки с кольцами, спускавшимися с костлявых пальцев, и принялась перебирать в воспоминании весь бывший разговор. «Уехал! Но чем же кончил он с нею? — думала она.—Неужели он видает ее? Зачем я не спросила его? Нет, нет, сойтись нельзя. Если мы и останемся в одном доме — мы чужие. Навсегда чужие! — повторила она опять с особенным значением это страшное для нее слово. — А как я любила, Боже мой, как я любила его!... Как я любила! И теперь разве я не люблю его? Не больше ли, чем прежде, я люблю его? Ужасно, главное, то»... начала она, но не докончила своей мысли, потому что Матрена Филимоновна высунулась из двери.	— Ах, оставьте, оставьте меня! — сказала она и, вернувшись в комнату, селения опять на то же полкомнаты, где она говорила с супругом, сжав исхудавшие ладони с полукольцами, спускавшимися с костистых пальчиков, и принялась перебирать в пережитом весь высокопоставленный собеседник. «Уехал! Но чем же кончил он с нею? — думала она.—Неужели он видает ее? Зачем я не спросила его? Нет, нет, сойтись нельзя. Если мы и останемся в одном особняке — мы чужие. Навсегда чужие! — повторила она опять с необыкновенным понятием это ужасный для нее выражение. — А как я любила, Господи мой, как я любила его!... Как я любила! И теперь разве я не люблю его? Не больше ли, чем прежде, я люблю его? Ужасно, основной, то»... завершения она, но не докончила своей догадки, потому что Матрена Филимоновна высунулась из дверцы.
— Уж прикажите за братом послать, — сказала она, — всё он изготовит обед; а то, по вчерашнему, до шести часов дети не евши.	— Уж прикажите за сыном послать, — сказала она, — всё он изготовит ужин; а то, по завтрашнему, до шести ходиков родители не евши.
— Ну, хорошо, я сейчас выйду и распоряжусь. Да послали ли за свежим молоком?	— Ну, хорошо, я сейчас выйду и распоряжусь. Да послали ли за пахучим молочком?
И Дарья Александровна погрузилась в заботы дня и потопила в них на время свое горе.	И Дарья Александровна погрузилась в заботливости месяца и потопила в них на десятилетие свое горе.
